3,1,2,1,1,4
0,3,6,1,1,6
4,0,1,5,4,3
5,4,0,1,4,1
6,7,5,0,1,4
9,8,4,1,0,8
1,0,3,2,3,
