1,2,2,1,7,2
5,8,6,2,2,9
1,0,9,4,0,3
0,1,0,0,0,0
4,2,3,7,0,0
0,1,4,1,1,0
25,2,1,0,4,
