1,3,4,5,3,6
5,4,0,3,5,3
6,0,7,6,5,6
0,9,8,6,7,1
7,8,9,3,3,2
1,8,3,6,2,5
10,99,99,99,99,
