-1,-1,-1,-1,7,8
-1,-1,1,-1,0,0
1,0,0,6,0,0
0,2,0,0,0,0
0,0,1,0,4,0
1,0,4,0,0,0
15,2,0,0,4,
