1,1,1,1,6,2
4,1,6,1,1,1
1,1,1,1,1,1
4,1,6,4,1,4
1,1,1,2,3,3
2,4,2,6,1,6
40,5,0,0,3,
