1,1,9,9,1,1
1,9,2,2,9,1
1,3,9,9,3,1
1,3,9,9,3,1
1,9,2,2,9,1
1,1,9,9,1,1
64,2,1,1,3,
