-1,-1,-1,-1,-1,-1
-1,-1,-1,-1,-1,-1
5,8,9,2,4,1
9,1,2,4,1,6
1,9,1,1,5,1
1,1,3,6,1,5
28,5,1,1,0,
