-1,-1,-1,-1,-1,-1
-1,5,-1,4,5,-1
0,0,8,1,2,5
9,4,6,0,0,0
0,2,9,1,0,7
4,0,8,5,8,4
50,1,2,0,1,
