-1,-1,-1,-1,-1,-1
-1,5,-1,4,5,-1
0,0,3,1,2,5
5,4,2,0,0,0
0,2,2,1,0,2
4,0,3,5,1,4
50,0,1,3,1,
